0 0 0 0 0 0 0 0 0 0 0 0 0 0 0 0 0 0 0
0 0 0 0 0 0 0 0 0 0 0 0 0 0 0 0 0 0 0
2 10 10 10 10 10 10 10 10 12 10 10 10 10 10 10 10 10 3
11 19 1 1 19 1 1 1 19 11 19 1 1 1 19 1 1 19 11
11 16 2 3 16 2 12 3 16 11 16 2 12 3 16 2 3 16 11
11 21 4 5 16 4 13 5 16 9 16 4 13 5 16 4 5 21 11
11 19 1 1 19 1 19 1 19 1 19 1 19 1 19 1 1 19 11
11 16 6 7 16 8 16 6 10 12 10 7 16 8 16 6 7 16 11
11 19 1 1 19 11 19 1 19 11 19 1 19 11 19 1 1 19 11
4 10 10 3 16 14 10 7 16 9 16 6 10 15 16 2 10 10 5
0 0 0 11 16 11 19 1 19 18 19 1 19 11 16 11 0 0 0
10 10 10 5 16 9 16 2 12 0 12 3 16 9 16 4 10 10 10
1 1 1 1 19 1 19 14 0 29 0 15 19 1 19 1 1 1 1
10 10 10 3 16 8 16 4 13 13 13 5 16 8 16 2 10 10 10
0 0 0 11 16 11 19 1 1 1 1 1 19 11 16 11 0 0 0
2 10 10 5 16 9 16 6 10 12 10 7 16 9 16 4 10 10 3
11 19 1 1 19 1 19 1 19 11 19 1 19 1 19 1 1 19 11
11 16 6 3 16 6 10 7 16 9 16 6 10 7 16 2 7 16 11
11 23 19 11 19 1 19 1 19 20 19 1 19 1 19 11 23 19 11
14 7 16 9 16 8 16 6 10 12 10 7 16 8 16 9 16 6 15
11 19 19 1 19 11 19 1 19 11 19 1 19 11 19 1 19 19 11
11 16 6 10 10 13 10 7 16 9 16 6 10 13 10 10 7 16 11
11 19 1 1 1 1 1 1 19 1 19 1 1 1 1 1 1 19 11
4 10 10 10 10 10 10 10 10 10 10 10 10 10 10 10 10 10 5
